1111111111111111111111111111
1100E00000C000000000000P0011
1111111111111111111111111111