1111111111111111111111
1000C0000E00000000P001
1111111111111111111111
