11111111111111111111111111111
1P000000000000000000000000CC1
100000000011100111111111100C1
10000000011100011111111110001
100000001110000000000CC110001
1000000111000000000000C110001
100000111C0000011111111110001
10000111CCC000011111111110001
10001111111110011C00000000001
10001111111110011CC0000000001
10000000000110011111111110001
10000000000110011111111110001
1C000000000000000000000000001
1CC000000000000000000000000E1
11111111111111111111111111111